5 5 5 5 5 5 5 5 8 5 5 5 5 5 5 5 5 5 5 5 5 5 5 5 5 5 5 5 5 5 5 5 5 5 5 5 5 5 5 5 5 5 5 5 5 5 1 5 5 5 5 5 5 5 5 5 5 5 5 8 5 5 5 5 5 5 5 5
5 5 5 5 5 5 5 5 8 5 5 5 5 5 5 5 1 1 1 1 1 1 1 1 1 1 1 1 1 5 5 5 5 5 5 5 5 5 5 5 5 5 1 1 5 5 5 5 5 5 5 5 5 5 5 5 5 5 5 8 5 5 5 5 5 5 5 5
5 5 5 5 5 5 5 5 8 5 5 5 5 5 5 5 5 5 5 5 5 5 1 5 5 5 5 5 5 5 5 5 5 5 5 5 5 1 1 5 5 1 1 1 5 5 5 5 5 5 1 5 5 5 1 1 5 5 5 8 5 5 5 5 5 5 5 5
5 5 5 5 5 5 5 5 8 5 5 5 5 5 5 5 5 5 5 5 5 5 5 1 5 5 5 5 5 5 5 1 5 1 1 5 5 5 5 5 5 5 5 5 5 5 5 5 5 5 5 5 5 5 1 1 5 5 5 8 5 5 5 5 5 5 5 5
5 5 5 5 5 5 5 5 8 5 5 5 5 5 1 1 5 5 5 5 5 5 5 5 5 5 5 5 5 5 5 1 5 5 1 1 5 5 1 5 5 5 5 5 5 5 1 1 1 1 1 5 5 5 5 5 1 5 5 8 5 5 5 5 5 5 5 5
5 5 5 5 5 5 5 5 8 5 5 5 5 1 5 5 5 5 5 1 5 5 5 5 5 5 5 5 5 5 5 5 5 5 5 5 5 5 5 5 1 5 5 5 5 5 5 5 5 5 1 1 1 5 5 5 5 5 5 8 5 5 5 5 5 5 5 5
5 5 5 5 5 5 5 5 8 5 5 5 5 1 1 1 5 5 5 5 5 5 5 5 5 1 1 1 5 5 5 5 5 5 5 5 5 5 5 5 5 5 5 5 5 5 5 5 5 5 5 5 5 5 5 5 5 5 5 8 5 5 5 5 5 5 5 5
5 5 5 5 5 5 5 5 8 5 5 5 5 5 5 5 5 5 5 5 5 5 5 5 5 5 5 5 5 5 5 5 5 5 5 5 5 5 5 5 5 5 5 5 5 5 5 5 5 5 5 5 5 5 5 5 5 5 5 8 5 5 5 5 5 5 5 5
5 5 5 5 5 5 5 5 8 5 5 5 5 5 5 5 5 5 5 5 5 5 5 5 5 5 5 5 5 5 4 3 5 5 5 0 5 5 5 0 5 5 5 5 5 5 5 5 5 5 5 5 5 5 5 5 5 2 5 8 5 5 5 5 5 5 5 5
0 0 0 0 0 0 0 0 7 0 0 0 0 5 5 5 5 5 5 5 5 5 4 3 3 5 5 5 5 3 4 4 5 5 5 0 5 5 5 0 5 5 5 5 5 3 3 5 5 5 3 3 5 5 0 0 0 0 0 7 0 0 0 0 0 0 0 0
0 0 0 0 0 0 0 0 7 0 0 0 0 6 6 6 3 3 3 3 6 6 4 4 4 4 6 6 4 4 4 4 6 6 6 0 6 6 6 0 6 6 6 4 3 4 4 6 6 3 4 4 4 6 6 0 0 0 0 7 0 0 0 0 0 0 0 0